XSXXXXXXXXXXXX
X      XXXX XX
X   X  XX    X
X X       X  X
XX   XX XXX  X
X  X   XX    X
X     X  X   X
XX   XXXXXX XX
XXXX XX  X   X
XX   XXXXXX XX
XXXX XX  X   X
XX   XXXXXX XX
XXXX XX  X   X
X  X  X      X
XXXXXXXXEXX XX
